BIG601-DIG - GENETICA E EVOLUCAO: Bases Mendelianas da hereditariedade. Tipos de transmissao de  ca-racteres geneticos em organismos haploides e diploides.   Naturezado material genetico. Recombinacao e mutacao em bacterias e virus.Variacao da estrutura e na expressao do genoma. Bases da  variacaoe mecanismos de evolucao. Formacao de racas e especies.
BIOQUIMICA CELULAR: Relação de estrutura e função de biomoléculas. Mecanismos de catálise biológica. Biossíntese e degradação de biomoléculas. 
CITOLOGIA E HISTOLOGIA GERAL: Célula eucariota e os tecidos animais: correlações bioquímicas e funcionais.
ANATOMIA VETERINARIA I: APARELHO LOCOMOTOR: OSTEOLOGIA, SINDESMOLOGIA E MIOLOGIA. TEGUMEN-TO COMUM.
PROFISSIOGRAFIA DO MEDICO VETERINARIO: Competências profissionais do médico veterinário nos setores público e privado. A carreira acadêmica, o pesquisador e o extensionista. O projeto pedagógico do curso de Medicina Veterinária da UFMG. Relação humana no ambiente profissional. Relações sociais que envolvem a Medicina Veterinária. 
METODOLOGIA DA PESQUISA CIENTIFICA: METODOS E TECNICAS DE INVESTIGACAO CIENTIFICA E EM EXPERIMENTACAO.EPISTEMOLOGIA E ETICA NA CONSTRUCAO DO SABER.
IMUNOLOGIA: IMUNOLOGIA E IMUNOQUIMICA. INDUCAO DAS RESPOSTAS CELULAR E HUMORALESTIMULADAS PELO ANTIGENO E SUAS CONSEQUENCIAS.
BIOFISICA: Processos fisiológicos: estudos quali e quantitativos utilizando-se abordagem físico-química.
HISTOLOGIA VETERINARIA: CELULA EUCARIOTICA E TECIDOS ANIMAIS: CORRELACOES MORFOLOGICAS,   BIOQUIMICAS E FUNCIONAIS.
SETOR AGRÁRIO E ORGANIZAÇÃO SOCIAL NO BRASIL: Processo histórico da formação colonial, assentada na produção agrária, e seus desdobramentos para outras atividades. Estruturas herdadas do processo de colonização ¿ distribuição fundiária. Análise da situação atual do desenvolvimento e das contradições acumuladas. Possibilidades e limitações oferecidas pelo setor agrário no resgate da justiça social do país, questões de gênero, geração e étnico-raciais. Semelhanças do Brasil com países latino-americanos. Relações e posição do Brasil no contexto mundial do agronegócio. Análise dos impactos sociais e ambientais do modelo produtivo. Consequências do produtivismo no meio ambiente. Violência no campo, acesso à posse da terra e direitos humanos das populações rurais. Violação dos direitos humanos relativos aos movimentos sociais e povos tradicionais. 
FISIOLOGIA VETERINARIA: Órgãos e sistemas do organismo animal: funções normais. Aspectos fisiológicos aplicáveis à prática veterinária.
MICROBIOLOGIA VETERINARIA: Organização celular e princípios de fisiologia, genética e taxonomia microbianas. Interações parasito-hospedeiro e fatores determinantes de patogenicidade. Fundamentos do diagnóstico etiológico, epidemiologia, profilaxia, controle de grupos de fungos, vírus e bactérias de interesse da medicina veterinária.
PARASITOLOGIA VETERINARIA: Etiologia de doenças parasitárias dos animais domésticos. Taxonomia e morfologia dos agentes etiológicos. Reconhecimento morfológico-sistemático e perspectivas atuais de controle dos vetores. Interações parasito/ hospedeiro/reservatório e vetor hospedeiro/reservatório: ciclo biológico, transmissão, patogenia, epidemiologia, profilaxia e diagnóstico.
PATOLOGIA VETERINARIA: ETIOPATOGENIA DAS ALTERACOES MACROSCOPICAS E MICROSCOPICAS DOS    PROCESSOS INFECCIOSOS, NUTRICIONAIS E METABOLICOS NOS DIFERENTES  ORGAOS E SISTEMAS DOS ANIMAIS DOMESTICOS. MORFOCLINICA DOS ACHADOSDE NECROPSIA.
FARMACOLOGIA VETERINARIA: ASPECTOS GERAIS DA FARMACOLOGIA: FARMACOCINETICA, FARMACODINAMICA,USOS TERAPEUTCOS E EFEITOS COLATERAIS DE MEDICAMENTOS DE USO VETE-RINARIO.
NUTRICAO ANIMAL: Estudo básico dos procedimentos para coleta de amostras de alimentos, análises bromatológicas e avaliação de alimentos. Estudo dos diferentes sistemas digestivos em monogástricos e ruminantes. Estudos dos nutrientes (água, proteínas, carboidratos, lípides, minerais e vitaminas). Estudo do valor energético dos alimentos. Estudo dos principais aditivos utilizados na alimentação animal. Estudo dos principais alimentos concentrados, energéticos e protéicos para ruminantes. 
SEMIOLOGIA VETERINARIA: Sistemas e órgãos dos animais domésticos: métodos de exame e iniciação na prática da clínica. Reconhecimento e interpretação das alterações.
PATOLOGIA CLINICA VETERINARIA: COLHEITA DE MATERIAL DE INTERESSE LABORATORIAL. TECNICAS DE ANALI-SE E INTERPRETACAO DE RESULTADOS DE EXAMES LABORATORIAIS NO DIAG- NOSTICO E PROGNOSTICO DE AFECCOES.
EPIDEMIOLOGIA: Problemas de saúde animal nos rebanhos: distribuição e magnitude. Fatores das doenças: estudos descritivos, analíticos e experimentais.
SANEAMENTO: Aborda assuntos voltados para higiene e saúde pública veterinárias nas áreas urbanas e rurais, no tocante à qualidade e disposição de águas de consumo e efluentes de origem animal e agroindustrial, assim como controle de vetores (roedores), higienização de sistemas de produção e educação ambiental. 
ALIMENTOS E ALIMENTACAO EM VETERINARIA: Estudo básico de botânica de forrageiras. Formação, recuperação e manejo de forrageiras. Alimentos volumosos e conservados. Principais gramíneas e leguminosas. Alimentos protéicos e energéticos na alimentação animal. 
ANESTESIOLOGIA VETERINARIA: PRE, POS-OPERATORIOS E TECNICAS ANESTESICAS BASICAS NOS ANIMAIS   DOMESTICOS.
TECNICA CIRURGICA VETERINARIA: CONHECIMENTO E MANIPULACAO DE INSTRUMENTAL CIRURGICO ESSENCIAL.   MANOBRAS E TECNICAS FUNDAMENTAIS EM CIRURGIA.
DOENCAS BACTERIANAS: EPIDEMIOLOGIA, DIAGNOSTICO LABORATORIAL E PROFILAXIA DAS PRINCI-  PAIS DOENCAS DOS ANIMAIS DOMESTICOS CAUSADAS POR BACTERIAS.
DOENÇAS PARASITÁRIAS E MICÓTICAS: Serão apresentados conhecimentos relacionados às enfermidades parasitárias e micóticas de maior relevância aos animais domésticos de produção e companhia, enfocando a epidemiologia, diagnóstico laboratorial e profilaxia. 
EXTENSÃO EM VETERINÁRIA: Conceitos de pedagogia, comunicação, filosofia, mobilização popular. Avaliação técnico-econômica de propriedades rurais. Atuação dos médicos veterinários junto aos produtores rurais, comunidades de movimentos sociais, comunidades remanescentes de quilombolas e comunidades indígenas. Avaliações técnico-econômicas de propriedades rurais. Atuação do médico veterinário e meio ambiente.
SUINOCULTURA: Producao e melhoramento genetico de suinos. Classificacao e tipi- ficacao de carcaca. Planejamento de unidades de producao.
PATOLOGIA E CLINICA CIRURGICA VETERINARIAS: Animais domésticos: tratamento das afecções cirúrgicas.
TOXICOLOGIA VETERINARIA: ALTERACOES CLINICAS, LABORATORIAIS E ANATOMO-HISTOPATOLOGICAS DE  INTOXICACOES.
CLINICA DE PEQUENOS ANIMAIS: PROPEDEUTICA, DIAGNOSTICO, PROGNOSTICO, TRATAMENTIO E CONTROLE DE AFECCOES DE PEQUENOS ANIMAIS
DIAGNOSTICO POR IMAGEM EM VETERINARIA: TECNICAS DE DIAGNOSTICO POR IMAGEM, APLICACAO E INTERPRETACAO DE  EXAMES NAS ESPECIES ANIMAIS. EQUIPAMENTOS GERADORES E PROTECAO.
TECNOLOGIA E INSPECAO DE AVES, OVOS, MEL E PESCADO: PROCESSAMENTO INDUSTRIAL, LEGISLACAO E FISCALIZACAO SANITARIA DE  AVES, OVOS, MEL E PESCADO.
CLINICA DE RUMINANTES I: Enfermidades próprias de ruminantes: diagnóstico, prognóstico clínico e controle das afecções de recém- nascidos, metabólicas e carências.
OBSTETRICIA VETERINARIA: Gestação, parto e puerpério nos animais domésticos e prática das principais intervenções cirúrgicas na fêmea e no feto.
CLINICA DE EQUIDEOS: Enfermidades próprias de eqüídeos: diagnóstico, prognóstico, tratamento clínico e controle.
PLANIFICACAO EM SAUDE ANIMAL: Produção e saúde animal: metodologia de planificação; elementos de elaboração e de administração de projetos, inclusive projetos técnicos econômicos em saúde animal.
PLANEJAMENTO E GESTAO EM VETERINARIA: RELACOES ECONOMICAS ENTRE OS SETORES URBANO E RURAL. FATORES DE   PRODUCAO. GESTAO E PLANEJAMENTO EM SAUDE E PRODUCAO ANIMAL.
